Apple	Red
Apple	
Avocado	Aqua
Banana	Yellow
Blackberry	Black
Calamondin	Yellow	0,12
Citron	Yellow	0,32
Dragonfruit	Red
Etrog	DarkOliveGreen	
Grape	Green
Grapefruit	Coquelicot	
Kabosu	ForestGreen	
Kiwi	Aqua
Orange	Orange	0,25
Peach	Coral
Pineapple	Aureolin
Pomelo	Green
Strawberry	Red
Sudachi	Green	0,05
Tangelo	Orange	
Tangerine	Orange	0,06
Tangor	Orange	0,1
Watermelon	Green
